<root><![CDATA[
##################    ###################
W###############       ##################
WW#########__             ____###########
WWWWW_________           __________######
WWWWWW_______________________________WW__
WWWWWWW_____________________________WW___
WW__WWWW_________________________WW______
WW____WWW_____________________WW___WW____
WW________________________________WW_____
WW______WWWW____________________WW_______
WW_________WWW_______________WW__________
WW_________________________________B_____
WW___________WWWW___________WW___________
WW______________WW_______________________
WW________________WW___________WWWW______
WW________________W______________________
WW________________WW_____________WW______
WW_______________________________________
WW___________WWW___________________WW____
WW________WW_____________________WW______
WW_______________________________________
WW______WW______________________WW_______
WW______WW_______________________________
WW____W_______________________WW_WW______
WW__________________________WW___________
WW___WW____________________WWW___________
WW___WW__________________________________
WW______WW__________________________WWWWW
WW______________________________WWWWWWWWW
WW_________________________WWWWWWWWWWWWWW
]]></root>