<root><![CDATA[
WWWWWWW_______________WWWWWWWWWWWWWWWWWWW
WWWWWWW_________________WWWWWWWWWWWWWWWWW
WWWWWWWWWW_________________WWWWWWWWWWWWWW
WWWWWWWWWWW___________________WWWWWWWWWWW
WWWWWWWWWWWWW__________________WWWWWWWWWW
WWWWWWWWWWWWWWWWWW_______________WWWWWWWW
WWWWWWWWWWWWWWWWWWWWW______________WWWWWW
WWWWWWWWWWWWWWWWWWWW_________________WWWW
WWWWWWWWWWWWWWWWWWWWWWWW_________________
WWWWWWWWWWWWWWWWWWWWWWWWWWWWWWW__________
WWWWWWWWWWWWWWWWWWWWWWWWWWWWWWW__________
WWWWWWWWWWWWWWWWWWWWWWWWWWWWWWWWW________
WWWWWWWWWWWWWWWWWWWWWWWWWWWWWWWWW________
WWWWWWWWWWWWWWWWWWWWWWWWWWWWWWWWWW_______
WWWWWWWWWWWWWWWWWWWWWWWWWWWWWWWWWW_______
WWWWWWWWWWWWWWWWWWWWWWWWWWWWWWWWWWW______
WWWWWWWWWWWWWWWWWWWWWWWWWWWWWWWWWWWWWWWWW
WWWWWWWWWWWWWWWWWWWWWWWWWWWWWWWWWWWWWWWWW
WWWWWWWWWWWWWWWWWWWWWWWWWWWWWWWWWWWWWWWWW
WWWWWWWWWWWWWWWWWWWWW___________WWWWWWWWW
WWWWWWWWWWW________________________WWWWWW
WWWWWWWWW___________________________WWWWW
WWWWWWW______________________________WWWW
WWWWWWW_______________________________WWW
WWWW________________WW_________________WW
WW_______________WWWWWW________________WW
______________WWWWWW___________________WW
___________WWWWWWW_____________________WW
_________WWWWWWWW______________________WW
______WWWWWWWWWW_______________________WW
]]></root>