<root><![CDATA[
TTTTTTTTTTTTTTTTTT_____TTTTTTTTTTTTTTTTTT
TTTTTTTTTTTTTTTTTT_____TTTTTTTTTTTTTTTTTT
TTTTTTTTTTTTTTTTTT_____TTTTTTTTTTTTTTTTTT
TTT___________________________________TTT
TTT___________________________________TTT
TTT___________________________________TTT
TTT___________________________________TTT
TTT___________________________________TTT
TTT___________________________________TTT
TTT___________________________________TTT
TTT___________________________________TTT
TTT___________________________________TTT
_________________________________________
_________________________________________
_________________________________________
_________________________________________
_________________________________________
TTT___________________________________TTT
TTT___________________________________TTT
TTT___________________________________TTT
TTT___________________________________TTT
TTT___________________________________TTT
TTT___________________________________TTT
TTT___________________________________TTT
TTT___________________________________TTT
TTT___________________________________TTT
TTT___________________________________TTT
TTTTTTTTTTTTTTTTTT_____TTTTTTTTTTTTTTTTTT
TTTTTTTTTTTTTTTTTT_____TTTTTTTTTTTTTTTTTT
TTTTTTTTTTTTTTTTTT_____TTTTTTTTTTTTTTTTTT
]]></root>