<root><![CDATA[
_______________________________________TT
_______________________________________TT
_______________________________________TT
_______________________________________TT
_______________________________________TT
_______________________________________TT
_______________________________________TT
_______________________________________TT
_______________________________________TT
_______________________________________TT
_______________________________________TT
_______________________________________TT
_______________________________________TT
_______________________________________TT
_______________________________________TT
_______________________________________TT
_______________________________________TT
_______________________________________TT
_______________________________________TT
_______________________________________TT
_______________________________________TT
_______________________________________TT
_______________________________________TT
_______________________________________TT
_____________________________s_________TT
_______________________________________TT
_______________________________________TT
_______________________________________TT
TTTTTTTTTTTTTTTTTTTTTTTTTTTTTTTTTTTTTTTTT
TTTTTTTTTTTTTTTTTTTTTTTTTTTTTTTTTTTTTTTTT
]]></root>