<root><![CDATA[
_______________________________________TT
_______________________________________TT
_______________________________________TT
_______________________________________TT
_______________T__________T___________TTT
_________T____________________________TTT
__________________________________T__TTTT
_____________________________________TTTT
____________T________T______T________TTTT
____T_______________________________TTTTT
________T___________________________TTTTT
_______________T________T___________TTTTT
___________________________________TTTTTT
_____T______T___________T_________TTTTTTT
_________________________________TTTTTTTT
_________________________________TTTTTTTT
________T________T_______________TTTTTTTT
___________________________T_____TTTTTTTT
________T_____T__________________TTTTTTTT
__________________________________TTTTTTT
___T_______________________________TTTTTT
_______________T_______T___________TTTTTT
T___________________________________TTTTT
________T___________________________TTTTT
________________T____________________TTTT
_____________________________________TTTT
_T_________________________T__________TTT
________T_____________________________TTT
_______________________T_______________TT
_______________________________________TT
]]></root>