55555555555555555500005555555555555555555
55555555555555555500005555555555555555555
55555555555555555500005555555555555555555
55500000000000000000000000000000000000555
55500010040000000000000001000000000000555
55500000000000001000000000000000000000555
55500000000000000000000400000000000000555
55500000010004000000000000000000000000555
55500000000000000000000000000010000400555
55500040000000000000000010001000000000555
55500000000000000040000400000000000000555
55500000000000010000000000000000000000555
55500000010000010000000004000001000000555
55500000000000000330000000000000040000555
55500000000400003300000000000000000000555
55500000000000003000100000001000000000555
55500001000000222220000000000000000000555
55500000001022222222200000000000000000555
55500004000022222222200000000000000000555
55500000000022222222200000000004000000555
55500000000000222220000000400004000000555
55500100000100000000000000000000000100555
55500000000000000000000100000000000000555
55500000000000000400000000000040000000555
55500000004000000000000000000000000000555
55500000000000010000000000040000000000555
55500000000000000000000000000000000000555
55555555555555555555555555555555555555555
55555555555555555555555555555555555555555
55555555555555555555555555555555555555555