<root><![CDATA[
55555555555555555500005555555555555555555
55555555555555555500005555555555555555555
55555555555555555500005555555555555555555
55510000000000000000000000000000000000555
55501100000000040000400000040000040000555
55500011000000000000000000000000000000555
55500000110000000000000000000000000000555
55500000001100000000000000040000000000555
55500000400011000000400000000000004000555
55500000000000110000000000000004000000555
55500040000000011100000000000000000000555
55500000000000000111000000040000000000555
55500000000400400001000000000000000000555
55500000000000000001000004000040000000555
00000000000000000001110000000000040000555
00000400000000000000011000000000000000555
00000000000000400000001110000000000000555
55500000000000000040000011100000400000555
55500000004000000000000000110000000000555
55500040000000000004000000011000000000555
55500000000000000000000000001110040000555
55500000000040000000000000000111100000555
55500004000000000400000400000000100000555
55500000000000000000000000000000100040555
55500000000000000000000000040000100000555
55500400000040000004000004000000000000555
55500000000000000000000000000000000000555
55555555555555555555555555555555555555555
55555555555555555555555555555555555555555
55555555555555555555555555555555555555555
]]></root>