<root><![CDATA[
TTTTTTTTTTTTTTTTTTTTTTTTTTTTTTTTTTTTTTTTT
TTTTTTTTTTTTTTT________________TTTTTTTTTT
TTTTTTTTTTTT________T_______________TTTTT
TTTTTTTTTTT___________________T_______TTT
TTTTTTTTTTTTT__________________________TT
TTTTTTTTTTTTTTTTT__TT____TT_____________T
TTTTTTT__TTTTTTTTTTTT____TTTT___________T
TTTTTTT___TTTTTTT__________TT___________T
TTTTTTT___TTTTTT________TTTTTT__________T
TTTTTT_____TTTT___T_________TT____T______
TTTTTT____TTTT_______________TT__________
TTTTTT____TTT_TTT_______T____TTT_________
TTT______TTT_________________TT__________
_________TT__T_______________TT_____T____
________TTT_____T______T______TT_________
_______TTT__TTT_______________TT_________
___T____TT__________T__________TT________
_______TT___________________T_TTTTT______
_______TT_TTTT____T___________TTTT_______
________TTTTTTT________T______TTT________
__________TT______________T_TTTTT_______T
___________TT____________TTTTTTT________T
_______T____TT____________TTTTT________TT
TTT__________TT________TTTTTTTT__T____TTT
TTTT__________TTTT______TTT_TTTT__TTTTTTT
TTTTT_________________TTTT___TTTTTTTTTTTT
TTTTTT_____________TTTTT______TTTTTTTTTTT
TTTTTTTT___T_________________TTTTTTTTTTTT
TTTTTTTTTT___T_T___________TTTTTTTTTTTTTT
TTTTTTTTTTTTTTTTTTTTTTTTTTTTTTTTTTTTTTTTT
]]></root>