<root><![CDATA[
TTTTTTTTTTTTTTTTTTTTTTTTTT_____________TT
TTTTTTTTTTTTTTTTTTTTTTTT_______________TT
TTTTTTTTTTTTTTTTTTTTT__________________TT
TTTTTTTTTTTT__________T_______________TTT
TTT__________________________________TTTT
T___________________________________TTTTT
_____________T_____T______________TTTTTTT
________T_________________________TTTTTTT
____T_________________T___________TTTTTTT
__________________T__________________TTTT
____T_________T_____________T________TTTT
________________________T____________TTTT
_______T________T____________________TTTT
__________________________________T__TTTT
____________T_____T______T___________TTTT
____T________________________________TTTT
__________T_________________T________TTTT
_______________T_____________________TTTT
__________T____________T____________TTTTT
_____T_______________________T_______TTTT
_____________________T_______________TTTT
__________T_______________T__________TTTT
____T________________________________TTTT
_________T_____T_____________T_____T_TTTT
_____________________________________TTTT
__________________T_______T__________TTTT
_______T____________T________________TTTT
____________T______________T_______TTTTTT
__T______________________________TTTTTTTT
TTTTTTTTTTTTTTTTTTTTTTTTTTTTTTTTTTTTTTTTT
]]></root>