<root><![CDATA[
TTTTTTTTTTTTTTTTTTTTTTTTTTTTTTTTTTTTTTTTT
TTTTTTTTTTTTTTTTTTTTTTTTTTTTTTTTTTTTTTTTT
TTTTTTTTTTTTT______________TTTTTTTTTTTTTT
TTTTTTTTTT____________________TTTTTTTTTTT
TTTTTTT__________T______________TTTTTTTTT
TTTTTT_____T________________________TTTTT
TTTTT____________________________________
TTTT______________________T______________
TT_______T__________T____________________
_________________________________T_______
_______T________________T________________
_________________________________________
________________T________T_______________
_______T____________________________T____
______________________________T__________
___T_________T____________T______________
____________________T____________________
_________________________________________
______T__________T_____________T_________
_________________________________________
TT___________________T______________T____
TTTT_____T_________________T_____________
TTTTT__________T_________________________
TTTTTT___________________________________
TTTTTTTTT_________________T_______T______
TTTTTTTTTTT______________________________
TTTTTTTTTTTTTT_____________T_____T_______
TTTTTTTTTTTTTTTTTTT______________________
TTTTTTTTTTTTTTTTTTTTTT___________________
TTTTTTTTTTTTTTTTTTTTTTTTTTTTTTTTTTTTTTTTT
]]></root>