<root><![CDATA[
##################    ###################
##################    ###################
##################    ###################
###                           @       ###
###                @          @       ###
###                @          @       ###
###   @            @     @    @       ###
###   @            @     @    @       ###
###   @     @      @     @    @       ###
###@  @     @            @            ###
###         @            @            ###
###    @    @    @               @    ###
###    @    @    @               @    ###
###    @         @    @          @    ###
###    @         @    @    @     @     ##
###  @           @    @    @     @     ##
###  @                @    @     @     ##
###  @                @    @     @    ###
###  @         @      @          @    ###
###  @         @                 @    ###
###  @         @                      ###
###       @    @        @             ###
###       @    @        @             ###
###       @    @        @      @      ###
###       @             @      @      ###
###       @             @      @      ###
###                            @      ###
##################    ###################
##################    ###################
##################    ###################
]]></root>