<root><![CDATA[
TTTTTT____________________WWWWWWWWW____WW
TTTTTT____________________WWWWWWWWW____WW
TTTTTT__________________________________W
TTTTTT______WWW_______________WWW_______W
TTTTTT___WWWWW_________________WW_______W
TTTTTT___WWWWWWW______________WWWW______W
TTTTTT___WWWWWWW____________WWWWW_______W
TTTTTT_____WW________________WWWWW______W
TTTTTT__________________________________W
TTTTTT__________WWW_____________________W
TTTTTT_________WWWWWW___________________W
TTTTTT__________WWWWWWWW________________W
TTTTTT___________WWWWWWWWW____________WWW
TTTTTT____________WWWWWWWWWW__________WWW
TTTTTT______________WWWWWW___________WWWW
TTTTTT______________________________WW__W
TTTTTT_____________________________WW___W
TTTTTT__________________________WWWW____W
TTTTTT________WWWWW____________WW__W____W
TTTTTT______WWWWWWWWW_________WW____W___W
TTTTTT_____WWWWWWWWWWWWW_____WW_________W
TTTTTT_______WWWWWWWWW________WW___N____W
TTTTTT_________________________W________W
TTTTTT________________________WW________W
TTTTTTWWW____________________WW__________
TTTTTTWWWWW___________________W__________
TTTTTTWWWWWWWWWWWW_______________________
TTTTTTWWWWWWWWWWWWWWWWWWWW_______________
TTTTTTWWWWWWWWWWWWWWWWWWWWWWWWWWWWWWWWWWW
TTTTTTWWWWWWWWWWWWWWWWWWWWWWWWWWWWWWWWWWW
]]></root>