<root><![CDATA[
22222222222222222222222222222222222222222
22222222222222222222222222222222222222222
22222222222222222222222222222222222222222
22222222222222222222222222222222222222222
22220000000000022222222222222222222222222
22200000000000000022222222222222222222222
22200022200000000000222222222222222222222
22200022220000000000000022222222222222222
22200022222000000000000000222222222222222
22200022222220000000000000000222222222222
22200022222222220000000000000000222222222
22200022222222222220000000000000000022222
22200022222222222222220000000000000002222
22200022222222222222222220000000000000222
00000022222222222222222222000000000000000
00000022222222222222222200000040000000000
00000022222222222222220000000000000000000
22222222222222222200000000000000000000555
22222222220000000000000000000000040000555
22222222200000000004000004000000000000555
55500000000000000000000000000000000000555
55500040000000040000000000000000040000555
55500000000000000000000000040000000000555
55500000000000000000400000000000000000555
55500000000040000000000000000000400000555
55500040000000000000000040000000000000555
55500000000000000000000000000000000000555
55555555555555555500005555555555555555555
55555555555555555500005555555555555555555
55555555555555555500005555555555555555555
]]></root>