<root><![CDATA[
WW_________________WWW___________W_______
WW_________________W_____________W_______
WW________________W________________W_____
WW______________W__W_______________W_____
WW_______W_____W____W____________________
WW_____W_______W___________________W_____
WW______________W________________________
WW______________W_________W________W_____
WWWWW___________WW______________W________
WW___WWW_________WW______________________
WW_____WWWWW_________________W___________
WW__________WWW__________________________
WW_____________WW________________________
WW______________________________W________
WW_________________W______________W______
WW_______________WW________________W_____
WW_______________W__________________W____
WW_____________________W_____________W___
WW_________WWW__________WW__________W____
WW________W________________________W_____
WW________W______________________________
WW_______WW__________________W___________
WW______WW____________________W__________
WW_____WW_____________________W__________
______________________________W__________
_____________________________W___________
______________________________W__________
_______________________________W_________
WWWWWWWWWWWWWWWWWWWWWWWWWWWWWWWWWWWWWWWWW
WWWWWWWWWWWWWWWWWWWWWWWWWWWWWWWWWWWWWWWWW
]]></root>