22222222222222222222222222222222222222222
22222222222222222222222222222222222222222
22222222222222222222222222222222222222222
22222222222222222222222222222222222222222
22222222222222220000000000222222222222222
22222222222200000000000000000002222222222
22222220000000000000000000000000000022222
22220000000000000000000000010000001010555
22200000000000001122200000000000050000555
22000000000010100220000000000000000001555
22000000001000002200000000000010000100555
22000000001000022100010000100010010055555
20000000000000220000000000000000000105555
20000011100002222011000000001000001055555
20000010000002222010000000000000010000000
20000000000010222222000000100000000000000
20000000010000002222220010000000000000000
22200000000001001002222220000011015000555
22200100000100000002222200000050005050555
22201000010000101122222000100000000550555
22225000000000022222222200000000100550555
22222000000022222222222220100000050550555
22222222222222222222222222205000000050555
22222222222222222222222220000000155050555
22222222222222200000000000015010055500555
22222222222222222220000000000000500500555
22222222222222222222222022102001000000555
22222222222222222222222222222222222222555
22222222222222222222222222222222222222255
22222222222222222222222222222222222222225