<root><![CDATA[
22222222222222222222222222222222222222222
22222222222222222222222222222222222222222
22222222222222222222222222222222222222222
22222222222222222222222222222222222222222
22222222222222222222222222222222222222222
22222222222222222222222222222222222222222
22222222222222222222222222222222222222222
22222222222222222222222222222222222222222
22222222222222222222222222222222222222222
22222222222222222222222222222222222222222
22222222222222222222222222222222222222222
22222222222222222222222222222222222222222
22222222222222222222222222222222222222222
22222222222222222222222222222222222222222
00000000000000002222000000000000022220000
00000000000000222222220000000002222000000
00000000000222220222222000000022220000000
55500000022220000022222200002222200000555
55500000022000000000022222222222000000555
55500000022000000000000222222220000000555
55550000022000000000000000000000000000555
55550000000000000000000000000000000000555
55550000000000000000000000000000000000555
55555000000000000000000000000000000000555
55555555555555555555555555555555555555555
55555555555555555555555555555555555555555
55555555555555555555555555555555555555555
55555555555555555500005555555555555555555
55555555555555555500005555555555555555555
55555555555555555500005555555555555555555
]]></root>