<root><![CDATA[
WWWWWWWWWWWWWWWWWWWWWWWWWWWWWWWWWWWWWWWWW
WWWWWWWWWWWWWWWWWWWWWWWWWWWWWWWWWWWWWWWWW
WWWWWWWW                                 
WWWWWW                                   
WWW                                      
WWW                                      
WW          _____________________________
WW        _______________________________
WW      _________________________________
WW      _________________________________
WW      _________________________________
WW      _________________________________
WW     __________________________________
WW     __________________________________
WW    ___________________________________
WWW  ____________________________________
WWW _____________________________________
##_______________________________________
##_______________________________________
##_______________________________________
##_______________________________________
##_______________________________________
##_______________________________________
###______________________________________
###______________________________________
#####____________________________________
#############____________________________
#####################____________________
#########################################
#########################################
]]></root>