<root><![CDATA[
T________________TTTTTTTTTTTTTTTTTTTTTTTT
T________________TTTTTTTTTTTTTTTTTTTTTTTT
T________________TTTTTTTTTTTTTTTTTTTTTTTT
T___________________TTTTTTTTTTTTTTTTTTTTT
T______________T_______TTTTTTTTTTTTTTTTTT
TT________________________TTTTTTTTTTTTTTT
TT_____T______________________TTTTTTTTTTT
TTT_______________________________TTTTTTT
TTT________________________________TTTTTT
TTT________________________________TTTTTT
TTTTT____________T___________T______TTTTT
TTTTTT_______________________________TTTT
TTTTTTTT______________________________TTT
TTTTTTTT_________________________________
TTTTTT_______________T____________T______
TTTTT____________________________________
TTTTT____T_______________________________
TTTT______________________T______________
TTTT____________T________________________
TTT______________________________________
TTT_____T______________T_________________
TT_____________________________T_________
TT_______________________________________
TT_______________T_________________TTTTTT
TT______T______________________TTTTTTTTTT
____________________________TTTTTTTTTTTTT
________________________TTTTTTTTTTTTTTTTT
_____________________TTTTTTTTTTTTTTTTTTTT
__________________TTTTTTTTTTTTTTTTTTTTTTT
TTTTTTTTTTTTTTTTTTTTTTTTTTTTTTTTTTTTTTTTT
]]></root>