55555555555555555500005555555555555555555
55555555555555555500005555555555555555555
55555555555555555500005555555555555555555
55500000000000000000000000000000000000555
55500000000000000000000000000000000000555
55500000000000000000000000000000000000555
55500000000000000000000000000000000000555
55500000000000000000000000000000000000555
55500000000000000000000000000000000000555
55500000000000000000000000000000000000555
55500000000000000000000000000000000000555
55500000000000000000000000000000000000555
55500000000000000000000000000000000000555
55500000000000000000000000000000000000555
00000000000000000000000000000000000000000
00000000000000000000000000000000000000000
00000000000000000000000000000000000000000
55500000000000000000000000000000000000555
55500000000000000000000000000000000000555
55500000000000000000000000000000000000555
55500000000000000000000000000000000000555
55500000000000000000000000000000000000555
55500000000000000000000000000000000000555
55500000000000000000000000000000000000555
55500000000000000000000000000000000000555
55500000000000000000000000000000000000555
55500000000000000000000000000000000000555
55555555555555555500005555555555555555555
55555555555555555500005555555555555555555
55555555555555555500005555555555555555555