<root><![CDATA[
WW_________________________WWWWWWWWWWWWWW
WW_________________________WWWWWWWWWWWWWW
WW_____________________WWWWWWWWWWWWWWWWWW
WW_________________WWWWWWWWWWWWWWWWWWWWWW
WW________________WWWWWWWWWWWWWWWWWWWWWWW
WW_____________WWWWWWWWWWWWWWWWWWWWWWWWWW
WW____________WWWWWWWWWWWWWWWWWWWWWWWWWWW
WW__________WWWWWWWWWWWWWWWWWWWWWWWWWWWWW
WWW________WWWWWWWWWWWWWWWWWWWWWWWWWWWWWW
WW_________WWWWWWWWWWWWWWWWWWWWWWWWWWWWWW
WW________WWWWWWWWWWWWWWWWWWWWWWWWWWWWWWW
WW________WWWWWWWWWWWWWWWWWWWWWWWWWWWWWWW
WW_______WWWWWWWWWWWWWWWWWWWWWWWWWWWWWWWW
WW_______WWWWWWWWWWWWWWWWWWWWWWWWWWWWWWWW
WW_______WWWWWWWWWWWWWWWWWWWWWWWWWWWWWWWW
WW__________WWWWWWWWWWWWWWWWWWWWWWWWWWWWW
WW_____________WWWWWWWWWWWWWWWWWWWWWWWWWW
WW_____________WWWWWWWWWWWWWWWWWWWWWWWWWW
WW________________WWWWWWWWWWWWWWWWWWWWWWW
WW___________________WWWWWWWWWWWWWWWWWWWW
WW_____________________WWWWWWWWWWWWWWWWWW
WWW_W__W____________________WWWWWWWWWWWWW
WW____________________________WWWWWWWWWWW
WW________W_____________________WWWWWWWWW
WW__________________________________WWWWW
WWW_________W__________________________WW
WW_____________W_________________________
WW_______________W_______________________
WW_______________W_______________________
WW_______________W_______________________
]]></root>