22222222222222222222222222222222222222333
22222222222222222222222222222222222222333
22222222222222222222222222222222222222333
22222000030000000000000000000000000000333
22222000000000000000000000300000000000333
22200000000032220000000000000003000000333
22200030000022200000003000000000000000333
22200020000222000000000300000000030000333
22200222302220000030000000000000003000333
22200222222200000000000003003000300000333
22200002222000300003000000222222200000333
22200030022200030000000002222222222000333
22200000002222222222222222222222200000333
22200000000222222222222222000000000000333
22200030000022222222222220000000330000000
22200000300002222000000000000300000000000
22200030000000022200000000000000000000000
22200000003000022222222220030000000000333
22200000000000222222222222203000000000333
22200030222000022222222222220030000300333
22200222222220000222222222222222222222333
22222222222222200000000000022222222222333
22222222222222220000000030000222222222333
22222222222222222000000000000000000000333
22222222222222222200000000000030000000333
22222222222222222200000000003300000000333
22222222222222222200000000000000030000333
22222222222222222200003333333333333333333
22222222222222222200003333333333333333333
22222222222222222200003333333333333333333