<root><![CDATA[
33333333333333333300003333333333333333333
33333333333333333300003333333333333333333
33333333333333333300003333333333333333333
33300000000003333300000000000000000000333
33300000000000033333300000000000000000333
33300000000000000333330000000000000000333
33300000000000000003333300000000000000333
33300000000000000000003333000000000000333
33300000000000000000000333300000000000333
33300000000000000000000033333300000000333
33300000000000000000000000000000000000333
33300000000000000000000000000000000000333
33300000003333333333333333333333333333333
33300000003333333333333333333333333333333
00000000000000000000000000000000000000000
00000000000000000000000000000000000000000
00000000000000000000000000000000000000000
33333333333000000000000333333333333333333
33333333333333000000000003333333333333333
33333333333333330000000000000000333330333
33333333333333333333000000000000000333333
33300000333333333333333300000000000000333
33300000000033333333333330000000000000333
33300000000000003333333333300000000000333
33300000000000000000333333333300000000333
33300000000000000000000000000000000000333
33300000000000000000000000000000000000333
33333333333333333300003333333333333333333
33333333333333333300003333333333333333333
33333333333333333300003333333333333333333
]]></root>