<root><![CDATA[
_______________________________________TT
_______________________________________TT
_______________________________________TT
___T___TT______________________________TT
________________________T______________TT
_______________________________________TT
______________________________T________TT
__________________________________TT___TT
_________________________T_____________TT
_______________________________T_______TT
___________T______TT_____T_____________TT
________________________________TT_____TT
__________________________T___T________TT
________________________________________T
_______________T_________TT__T__________T
______________________________TT________T
_TT____________________________TTT______T
_________________________________TTT____T
______________________T_____________TTTTT
_______T_______________________________TT
_______________________________________TT
_______________________________________TT
____TT_____________T_________________T_TT
_________TT____________________________TT
___________TT__________________________TT
__TT________TT_________________________TT
______T________________________________TT
________________TTT__________T_________TT
________TTTTTTTTTTTTTTTTT______________TT
TTTTTTTTTTTTTTTTTTTTTTTTTT_____________TT
]]></root>