<root><![CDATA[
##################    ###################
##################    ###################
##################    ###################
###                                   ###
###                                   ###
###                                   ###
###        @                          ###
###        @                          ###
###         @     @           @       ###
###         @                @        ###
###          @              @         ###
###           @            @          ###
###            @          @           ###
###             @        @            ###
###   @          @      @       @     ###
###               @   @@              ###
###                @@@                ###
###                 @                 ###
###                @          @       ###
###               @ @                 ###
###        @     @                    ###
###             @         @           ###
###          @@@              @       ###
###        @@           @             ###
###       @                           ###
###  @                           @    ###
###                                   ###
##################    ###################
##################    ###################
##################    ###################
]]></root>