<root><![CDATA[
55555555555555555     5555555555555555555
TTTTTTTTTTTTTTTT        TTTTTTTTTTTTTTTTT
TTTTTTTTTTTTT_____________TTTTTTTTTTTTTTT
TTTTTTTTTT___________________TTTTTTTTTTTT
TTTTTTTT________________________TTTTTTTTT
TTTTTT___________________________________
TTTT_____________________________________
TTT________T_____________________________
TT________________________T______________
T________________________________________
_________________________________________
_________________________________________
_________T______________T________T_______
_________________________________________
____T__________T_________________________
____________________________T____________
_________________________________________
_________________________________________
__________________T______________________
_____T______________________T____________
______________T__________________________
__________________________________T______
_________________________________________
_________________________________________
____________________T__________T_________
______T__________________________________
_________________________________________
_____________________T___________________
____T____________________________________
TTTTTTTTTTTTTTTTTTTTTTTTTTTTTTTTTTTTTTTTT
]]></root>