<root><![CDATA[
333333333333333333    3333333333333333333
T_______________________________________T
T_______________________________________T
T_______________________________________T
T_______________________________________T
T_______________________________________T
T_______________________________________T
T_______________________________________T
T_______________________________________T
T_______________________________________T
T________________________________________
T________________________________________
T________________________________________
T________________________________________
T________________________________________
T________________________________________
T________________________________________
T________________________________________
T________________________________________
T________________________________________
T________________________________________
T________________________________________
T________________________________________
T________________________________________
T________________________________________
T________________________________________
T________________________________________
T________________________________________
T________________________________________
TTTTTTTTTTTTTTTTTTTTTTTTTTTTTTTTTTTTTTTTT
]]></root>