<root><![CDATA[
#########################################
#########################################
########_________________________________
##_______________________________________
_________________________WWWW____________
_________________________________________
_________WWW_____________________________
__________________WWWW___________________
______________________________WWWW_______
_________________________________________
_____WWWW________________________________
_______________WWW___WWW_________________
__________________WWW______WWW___________
_________________________________________
____________WWW__________________________
_______WWWW______________________________
_________________________________________
_________________________________________
_________________________WWWWWWWWWWWWWWWW
____WWWW_____________WWWWWWWWWWWWWWWWWWWW
__________________WWWWWWWWWWWWWWW________
______________WWWWWWWWWWWW_______________
____________WWWWWWW______________________
___________WWWW__________________________
_______WWWWW_____________________________
______WWWWW______________________________
____WWWWW_______________________WWWWWWWWW
____WWWW___________________WWWWWWWWWWWWWW
WWWWWWW_______________WWWWWWWWWWWWWWWWWWW
WWWWWWW_______________WWWWWWWWWWWWWWWWWWW
]]></root>