<root><![CDATA[
______WWWWWWWWWW_______________________WW
_________WWWWWWW_______________________WW
____________WWWWWW_____________________WW
______________WWWWWW___________________WW
WW________________WWWWWW_______________WW
____________________WWWWWWW____________WW
______________________WWWWWWW__________WW
__________________________WWWWW________WW
___________________________WWWW________WW
__________________________WWWWW________WW
__________________________WWWWW________WW
WW_______________________WWWWW_________WW
WW______________________WWWWWW___________
________________________WWWWWWW__________
_________________________WWWWWW__________
___________________________WWWWW_________
____________________________WWWWWWW______
_____________________________WWWWWWWWWWWW
________________________________WWWWWWWWW
WW______________________________WWWWWWWWW
________________________________WWWWWWWWW
______________________________WWWWWWWWWWW
____________________________WWWWWWWWWWWWW
__________________________WWWWWWWWWWW____
_______________________WWWWWWWWWWWWW_____
_____________________WWWWWWWWWWWWW_______
___________________WWWWWWWWWWWWW_________
_________________WWWWWWWWWWWWW___________
______________WWWWWWWWWWWWWWWW___________
______________WWWWWWWWWWWWWWWW___________
]]></root>