55555555555555555500005555555555555555555
55555555555555555500005555555555555555555
55555555555555555500005555555555555555555
55500000000004000000000000000000000000555
55500000000000000000040000000000000000555
55500003330000000000000000000000004000555
55500003330000004000000000440000000000555
55500003330000000000400000000000000000555
55500003330040000000000000040000000000555
55500003330000000000000000000000000000555
55500003330000040000000000000000400000555
55500003330000000400040000000000000000555
55500003330000000000000000000000000000555
55504003330400000000000000000040000400555
55500003330000040000000000000000000000555
55500003330000000000000400000000000000555
55500003330000000000000000000000000000555
55500003333333333333333333333333333333555
55500003333333333333333333333333333333555
55500003333333333333333333333333333333555
55500040000000000000000000000000000000555
55500000000000000004000000040000000000555
55500000000000000000000000000000004000555
55500000000004000004000000000000000000555
55500004000000000000000000004000000400555
55500000000000000000000000000000000000555
55500000000000000000000000000000000000555
55555555555555555500005555555555555555555
55555555555555555500005555555555555555555
55555555555555555500005555555555555555555