33333333333333333300003333333333333333333
33333333333333333300003333333333333333333
33333333333333333300003333333333333333333
33300000000055555555000000000000000000333
33300005050050555500000000000000000000333
33300500050505055555000000000040000000333
33300000400000045555000000000000000000333
33340005000000505555555000000000000000333
33300000000500500000555500000000000000333
33300000000000000055055500000000000000333
33300000050000055000055550000040000000333
33300000000005000005505555000000000000333
33300000000000000000005555500000000000333
33300000000000050000005005500000000000333
00000000000000040005050555555000000000000
00000004000000000000505005555040000000000
00000000000000005000000005055500000000000
33300000000000000000045000500555555555333
33300000000000000000000000050505555555333
33300000004000000000500000000000555555333
33300000000000000040000000005500004555333
33300000000000000000000000000005000000333
33300000000000000000000000004050050000333
33300400000000400000440000000000000000333
33300000000000000000000000000000000500333
33300000000000000000000000000000040000333
33300000400000000000000004000000000000333
33333333333333333300003333333333333333333
33333333333333333300003333333333333333333
33333333333333333300003333333333333333333