<root><![CDATA[
##################    ###################
##################    ###################
####TTTTTTTT___          _###############
###TTTTTTT______     ________############
##TTTTTT________   ____________##########
TTTTTTTT__________________________#######
TTTTTTT_____________________________#####
TTTTTT_______________T________________###
TTTTTT_____T_______________T__________TTT
TTTTTT________________________________TTT
TTTTT____________T_______________________
TTTTT_________________T_______T__________
TTTTTTT______T___________________________
TTTT_____________________________________
TTTT_______________________T_____________
TTTT______________T________________T_____
TTTTT____________________________________
TTTT_____T_______________________________
TTTT_______TT_______________T_______T____
TTTT________________T____________________
TTTT_____________________________________
TTTT_________TT_______________T__________
TTT_____________T________________________
TTT______________________T_______________
TTT___TT__________________________T______
TTT_________________TT___________________
TT_______________________T____________T__
TT______T______________________T_________
TT_____________T_________________________
TT_______________________________________
]]></root>