<root><![CDATA[
333333333333333333    3333333333333333333
T_T___________________________T_________T
T_______________________________________T
T_______T__________________________T____T
T_______________________________________T
T_______________________________________T
T______________________T________________T
T___T________T_________________T________T
T_______T_______________________________T
T_______________________________________T
T_T______________T_______________________
T_________________________T________T_____
T________________________________________
T_______T________T_______________________
T________________________________________
T_________________________T_______T______
T__________T_____________________________
T____T_________T_________________________
T________________________________________
T____________________T_____________T_____
T________________________________________
T_________T______T_______________________
T_T____________________________T_________
T________________________________________
T______H_________________________________
T______________T_________________________
T__T_____________________T_______________
T___________________________________T____
T_______T_____________________T__________
T________________TTTTTTTTTTTTTTTTTTTTTTTT
]]></root>