<root><![CDATA[
TT_______________________________________
TT_______________________________________
TT____T__________________________________
TT____________T__________________________
TTT____________________T__________T______
TTT______________T_______________________
TTTT__T__________________________________
TTTT_____________________________________
TTTT________________T________T______T____
TTTTT_______T____________________________
TTTTT___________T________________________
TTTTT__________________T________T________
TTTTTT___________________________________
TTTTTTT______T______T___________T________
TTTTTTTT_________________________________
TTTTTTTT_________________________________
TTTTTTTT________T________T_______________
TTTTTTTT___________________________T_____
TTTTTTTT________T_____T__________________
TTTTTTT__________________________________
TTTTTT_____T_____________________________
TTTTTT_________________T_______T_________
TTTTT___T________________________________
TTTTT___________T________________________
TTTT____________________T________________
TTTT_____________________________________
TTT______T_________________________T_____
TTT_____________T________________________
TT_____________________________T_________
TT_______________________________________
]]></root>