<root><![CDATA[
WW_______________W_______________________
WW_______________________________________
WW_________WW____________________________
WW______WW_______________________________
WW__WW________________________________WWW
WW_______________________________________
WW_______________________________WWW_____
WW_______________________________________
WW_____________________WWWW______________
WW_______________________________________
WW______________WWW______________________
WW______WWWWW__________________________WW
WW___________________________________WWWW
WW_______________________________________
WW_______________________________________
WWWW______________________________WWW____
WW_______________________________________
WW_____WWW_________________WWW___________
WW_________WW____________________________
WW____________WW_____WWW______________WWW
WW______________W___________________W____
WW_______________W_______________________
WW________________W______________________
WW_______________W________________WW_____
WW______________W_______________W________
WW______________________________W________
WW_______________________________W_______
WW_________________W_____________W_______
WW__________________W____________________
WW_________________WWW___________W_______
]]></root>