<root><![CDATA[
TT_______________________________________
TT_______________________________________
TT_____________________________T_________
TT___________T_______T___________________
T_____________________________________T__
_______T_________________________________
_________________________________________
_________________________________________
_____________________T_______T___________
_________________________________________
________T________________________________
_________________________________________
__________________T__________T___________
_________________________________________
_________________________________________
__________T______________T_______________
_________________________________________
_____T___________T_______________________
____________________________________T____
__________________________T______________
_________________________________________
______T__________________________________
____________________T____________T_______
_____________T___________________________
_________________________________________
_________________________________________
____T_________________________T__________
__________________T______________________
_________________________________________
TTTTTTTTTTTTTTTTTTTTTTTTTTTTTTTTTTTTTTTTT
]]></root>