<root><![CDATA[
55555555555555555500005555555555555555555
55555555555555555500005555555555555555555
55555555555555555500005555555555555555555
55500000000000000000005500000000000000555
55500000000000000000005500000000000000555
55500055555555555500555555555555550000555
55500000000000000000555555550000000000555
55500000500000000000000055550000000000555
55500000500000000000005555550000555000555
55500000555555555555555555555005500000555
55500000000000000000000000000055000000555
55500000000000000000000000005550000000555
55555555555555555555555555555555555000555
55555555555555555555555555555555555000555
00000055555000000000050000000000005000555
00000055550000000005000000000000005000555
00000055500000000500000000000000005000555
55500055500000050000000000050000005000555
55500055500005000000000005000000005000555
55500055500000000000000500000000050000555
55500055000000000000050000000005000000555
55500050000000000005000000000500000000555
55500000000055555555555500000000000000555
55500000000555555555555550000000000000555
55500000005555555555555550000000000000555
55500000000000000000005555000000000000555
55500000000000000000005555500000000000555
55555555555555555500005555555555555555555
55555555555555555500005555555555555555555
55555555555555555500005555555555555555555
]]></root>