<root><![CDATA[
##################    ###################
##################    #################WW
################        ##############WWW
Ttttttttt____              __________WWWW
TTttttt_______            ___________WWWW
TTTtttt______           ______________WWW
TTTTttt_______    ___   ______________WWW
TTTTTT__________  ___________WWWW_____WWW
TTTTTT_________ _____________WWWWWW____WW
TTT___________ _____________WWWWWW_____WW
TTT____________________________________WW
TTT_____________ ______________________WW
TTT____________________________________WW
_______________________________________WW
____________________WWWWWWWWWW_________WW
_________________WWWWWWWWWWW___________WW
_____________WWWWWWWWWWWWW_____________WW
_______________WWWWWWWWW_______________WW
TTT_______________WWWWW________________WW
TTT____________________________________WW
TTTTTT_________________________________WW
TTTTTT_________________________________WW
TTTTTT_________________________________WW
TTTTTT_WWWWWWWW________________________WW
TTTTTTWWWWWWWWWWWWW____________________WW
TTTTTTWWWWWWWWWWW______________________WW
TTTTTTWWWWWWWW_________________________WW
TTTTTTWWWWW____________________________WW
TTTTTT_________________________________WW
TTTTTT____________________WWWWWWWWW____WW
]]></root>