<root><![CDATA[
______________WWWWWWWWWWWWWWWW___________
______________WWWWWWWWWWWWWWWW___________
____________WWWWWWWWWWWWWWW______________
___________WWWWWWWWWWWWWW________________
____________WWWWWWWWWW___________________
______________WWWWWWW____________________
_________________________________________
________________________________WWW______
_______________________________WWW_______
_______________________________WW________
_________________________________________
_________________________________________
_________________________________________
_________________WWWWW___________________
________________WWWWWWW__________________
_________________WWWW____________________
_________________WWWWWWW_________________
___________________WWWWWWW_______________
____________________WWWWWWW______________
_____________________WWWW________________
_________________________________________
_________________________________________
________WWW______________________________
________WWWWW____________________________
________WWWWWW___________________________
__________WWW____________________________
_________________________________________
_________________________________________
WWWWWWWWWWWWWWWWWWWWWWWWWWWWWWWWWWWWWWWWW
WWWWWWWWWWWWWWWWWWWWWWWWWWWWWWWWWWWWWWWWW
]]></root>