<root><![CDATA[
22222222222222222222222222222222222222222
22222222222222222222222222222222222222222
22222222222222222222222222222222222222222
22222222222222222200000000000000000000333
22222222222222222000000000300000000000333
22222222222222220000000000000003000000333
22222222222222200000003000000000000000333
33222222222222000000000300000000030000333
33302222222220000030000000000000003000333
33300222222200000000000003003000300000333
33300002222000300003000000222222222222222
33300030022200030000000002222222222222222
33300000002220000000000022222222222222222
33300000000222000303003222000000000000333
00000030000022200000022220000000330000000
00000000300002220222222300000300000000000
00000030000000222222222200000000000000000
33300000003000022222022220030000000000333
33300000000002220000000222203000000000333
33300030222222200000003022220030000300333
33300222222222033330000302222222222222222
33300222222000000000000000022222222222222
33300003000033300000000030000222222222222
33300000000000000000000000000000000000333
33300303300000000300000000000030000000333
33300300000030000030000000003300000000333
33300300000000000000000000000000030000333
33333333333333333300003333333333333333333
33333333333333333300003333333333333333333
33333333333333333300003333333333333333333
]]></root>